NO   ./textures/north.xpm             
SO   ./textures/south.xpm             
WE   ./textures/west.xpm             
EA   ./textures/east.xpm             


F          220      ,     100    ,      0            
C        225     ,       30     ,       0          


1111111111111111111111
1N00000000000000000001
1000000000000000000001
1000111111111100000001
1000100000000100000001
1000100111110100000001
1000100100000100000001
1000100100000100000001
1000100100000111111001
1000100100000000000001
1000100111111111111111
1000100000000000000001
1111111111111111111111
